WE ../../textures/w3d_wall_blue.xpm
NO ../../textures/w3d_wall_blue.xpm
SO ../../textures/w3d_wall_blue.xpm
EA ../../textures/w3d_wall_blue.xpm
D ../../textures/w3d_door_l.xpm
P ../../textures/tpk_sprite_barrel_warn.xpm
F 131,131,131
C 0,0,131


                                                1111111111111
                        111111                  1000000000001
                        100001       1111111111110000000000011111
                        100001       1000000000010000000000010001
                        1000001      10000000000D00000000000D0001
                        1000001      1000000000010000000000010001
                        11111D11111  1000111111110000000000011111
                        10000000001  10001      1000000000001
                        10000000001111000111     11111D111111
                        10000000001000000001        10001
                        1000000000D000000001        10001
                        10000000001000000001        10001
                   1111110000000001111111111        10001
                   1000110000000001                 10001
                   1000111111D1111            1111111000111
                   1000100010001              100D000000001
                   11D1100010001              1001111000111
                   1000111110001              10011110001
                   1000100010001              11111110001
                   1000D00010001                    10001
                   1000100010001                    11D11                1111111111
                   1000111111D11111          1111111000001111111         1000000001
                   1000110000000001          1000000000000000011         1000000001
                   1000110000000001          10000000000000000111111111111000000001
                   1000110000000001          10000000000000000010000000001000000001
                   1000010000000001          100000000000000000D000000000D000000001
                   10000D0000000001          10000000000000000010000000001000000001
                   1000010000000001          10000000000000000111100001111000000001
                   1000110000000001          1000000000000000011111001   1000000001
                   1000110000000001          111111100000111111   1001   1000000001
                   1000110000000001                111D11         1001   1000000001
                   1000111111D11111                 10001         1001   1000000001
                   1000111110001                    10001         1001   1000000001
                   1000111110001                    10001         1001   1000000001
                   1000100010001                    10001         1001   1111111111
                   1000D00010001                    10001         1001
                   1000100010001                    10001         1001
                   1000111110001                    10001         100111111111111
                   1000111110001111111111111        10001         100010000000001
                   100000000000000001000000111      10001         1000D0000000001
                   10000000000000000D000000D01      10001         100010000000001
                   100000000000000001000000111      10001         111111111111111
                   111111111111111111D111111        10001
                             1100100D001            10001
                            1D000100101       11111111D11111111
                             110000011        10000010001000001
                               1D1111         100000D000D000001
                               1001           10000010001000001
                               1001           10000010001000001
                               1111           11111110001111111
                                              10000010001000001
                                              1E0000D000D000001
                                              10000010001000001
                                              11111110001111111
                                              10000000000000001
                                              10000000000000001
                                              10000000000000001
                                              11111111111111111