   WE                            ../../textures/prototype_red.xpm
NO      ../../textures/prototype_red.xpm





SO ../../textures/prototype_red.xpm

F      17,38,64

                EA ../../textures/prototype_red.xpm

D   ../../textures/prototype_green.xpm

C 218,234,235

1111111111111111111111111
10S0110000100000000000001
1000110000000000111111001
100011000010000011000D001
1000D00000D00000000001001
1111111111111111111111111
